########################################################
##                        ####                        ##
##  ########  ##########  ####  ##########  ########  ##
##  ########  ##########  ####  ##########  ########  ##
##  ########  ##########  ####  ##########  ########  ##
##                                                    ##
##  ########  ####  ################  ####  ########  ##
##  ########  ####  ################  ####  ########  ##
##            ####        ####        ####            ##
############  ##########  ####  ##########  ############
############  ##########  ####  ##########  ############
############  ####                    ####  ############
############  ####  ######    ######  ####  ############
############  ####  ##            ##  ####  ############
                    ##            ##          	        
############  ####  ##            ##  ####  ############
############  ####  ################  ####  ############
############  ####                    ####  ############
############  ####  ################  ####  ############
############  ####  ################  ####  ############
##                        ####                        ##
##  ########  ##########  ####  ##########  ########  ##
##  ########  ##########  ####  ##########  ########  ##
##      ####                                ####      ##
######  ####  ####  ################  ####  ####  ######
######  ####  ####  ################  ####  ####  ######
##            ####        ####        ####            ##
##  ####################  ####  ####################  ##
##  ####################  ####  ####################  ##
##                                                    ##
########################################################

############################
#            ##            #
# #### ##### ## ##### #### #
# #### ##### ## ##### #### #
# #### ##### ## ##### #### #
#                          #
# #### ## ######## ## #### #
# #### ## ######## ## #### #
#      ##    ##    ##      #
###### ##### ## ##### ######
###### ##### ## ##### ######
###### ##          ## ######
###### ## ###  ### ## ######
###### ## #      # ## ######
          #      #          
###### ## #      # ## ######
###### ## ######## ## ######
###### ##          ## ######
###### ## ######## ## ######
###### ## ######## ## ######
#            ##            #
# #### ##### ## ##### #### #
# #### ##### ## ##### #### #
#   ##                ##   #
### ## ## ######## ## ## ###
### ## ## ######## ## ## ###
#      ##    ##    ##      #
# ########## ## ########## #
#                          #
############################