########################################################
##                        ####                        ##
##  ########  ##########  ####  ##########  ########  ##
##  ########  ##########  ####  ##########  ########  ##
##  ########  ##########  ####  ##########  ########  ##
##                                                    ##
##  ########  ####  ################  ####  ########  ##
##  ########  ####  ################  ####  ########  ##
##            ####        ####        ####            ##
############  ##########  ####  ##########  ############
############  ##########  ####  ##########  ############
############  ####                    ####  ############
############  ####  ######    ######  ####  ############
############  ####  ##            ##  ####  ############
                    ##            ##          	        
############  ####  ##            ##  ####  ############
############  ####  ################  ####  ############
############  ####                    ####  ############
############  ####  ################  ####  ############
############  ####  ################  ####  ############
##                        ####                        ##
##  ########  ##########  ####  ##########  ########  ##
##  ########  ##########  ####  ##########  ########  ##
##      ####                                ####      ##
######  ####  ####  ################  ####  ####  ######
######  ####  ####  ################  ####  ####  ######
##            ####        ####        ####            ##
##  ####################  ####  ####################  ##
##  ####################  ####  ####################  ##
##                                                    ##
########################################################